S0000000000000H0000000000000T
$                           0
$                           0
$                           0
$                           0
$                           0
$                           0
M0000000000000P0000000000000G